##############
#     ##     #
###  # # ### #
#   ##   # # #
# #    ##    #
# ##### ### ##
#       #    #
## ### #  #  #
## # #   ### #
#  # #### #  #
# #   #     ##
# ### # ###  #
#       S  # #
##########E###
