###############
#    ###   #  #
#S##   # #### #
###  # # #    #
#   ## # # # ##
#####  # ###  #
#     ##      #
# #####  # ####
# #     ## #  #
#   # # #  # ##
##### # # ## ##
#  ## # #     #
##    ### ### E
#  ##   # #   #
###############
