#########E#########
#      ## ### #   #
######    #   # # #
##     ## # ##  # #
#  ###  # #    ####
# ## ## #   ##    #
# #   ### ##### # #
#   ###    #    # #
## ## ### ## #### #
#   #    S # #  ###
######### ## ##   #
#         ##  ## ##
## ## ###  ##### ##
##### # ## #     ##
#     #  # ### ## #
## ##### #   # #  #
#  # # # ##### # ##
# ## #   # #      #
#      #     ## # #
###################
