#E#########
#   ##    #
###    ## #
#   ##    #
# #  S ## #
# # #     #
#   # #  ##
# #    #  #
# # #  #  #
###########
