########
#      E
# ######
# #    #
# #S## #
# #### #
#      #
########
